3 3 3 3 3 3 3 3 3 3 3 3 3 3 3 3 3 3 3 3 3 3 3 3 3 3 3 3 3 3 3 3 3 3 3 3 3 3 3 3 3 3 3 3 3 3 3 3 3 3 3 3 3 3 3 3 3 3 3 3 3 3 3 3
3 3 3 3 3 3 3 3 3 3 3 3 3 3 3 3 3 3 3 3 3 3 3 3 3 3 3 3 3 3 3 3 3 3 3 3 3 3 3 3 3 3 3 3 3 3 3 3 3 3 3 3 3 3 3 3 3 3 3 3 3 3 3 3
3 3 3 3 3 3 3 3 3 3 3 3 3 3 3 3 3 3 3 3 3 3 3 3 3 3 3 3 3 3 3 3 3 3 3 3 3 3 3 3 3 3 3 3 3 3 3 3 3 3 3 3 3 3 3 3 3 3 3 3 3 3 3 3
3 3 3 3 3 3 3 3 3 3 3 3 3 3 3 3 3 3 3 3 3 3 3 3 3 3 3 3 3 3 3 3 3 3 3 3 3 3 3 3 3 3 3 3 3 3 3 3 3 3 3 3 3 3 3 3 3 3 3 3 3 3 3 3
3 3 3 3 3 3 3 3 3 3 3 3 3 3 3 3 3 3 3 3 3 3 3 3 3 3 3 3 3 3 3 3 3 3 3 3 3 3 3 3 3 3 3 3 3 3 3 3 3 3 3 3 3 3 3 3 3 3 3 3 3 3 3 3
3 3 3 3 3 3 3 3 3 3 3 3 3 3 3 3 3 3 3 3 3 3 3 3 3 3 3 3 3 3 3 3 3 3 3 3 3 3 3 3 3 3 3 3 3 3 3 3 3 3 3 3 3 3 3 3 3 3 3 3 3 3 3 3
3 3 3 3 3 3 3 3 8 8 8 8 8 8 7 8 8 8 8 8 8 8 8 8 8 8 8 8 8 7 8 8 8 8 8 8 8 8 8 8 8 8 7 8 8 8 8 8 8 8 8 8 8 7 8 8 3 3 3 3 3 3 3 3
3 3 3 3 3 3 3 3 8 8 8 8 8 8 7 8 8 8 8 8 8 8 8 8 8 8 8 8 8 7 8 8 8 8 8 8 8 8 8 8 8 8 7 8 8 8 8 8 8 8 8 8 8 7 8 8 3 3 3 3 3 3 3 3
3 3 3 3 3 3 3 3 8 8 8 8 7 7 7 8 8 7 7 7 7 7 7 8 8 7 8 8 8 7 7 7 7 7 7 7 7 7 7 8 8 8 7 7 7 7 7 7 7 7 7 8 8 7 8 8 3 3 3 3 3 3 3 3
3 3 3 3 3 3 3 3 8 8 8 8 8 8 8 8 8 7 8 8 8 8 8 8 8 7 8 8 8 8 8 8 8 8 8 8 8 8 7 8 8 8 8 8 8 8 8 8 8 8 7 8 8 7 8 8 3 3 3 3 3 3 3 3
3 3 3 3 3 3 3 3 8 8 8 8 8 8 8 8 8 7 8 8 8 8 8 8 8 7 8 8 8 8 8 8 8 8 8 8 8 8 7 8 8 8 8 8 8 8 8 8 8 8 7 8 8 7 8 8 3 3 3 3 3 3 3 3
3 3 3 3 3 3 3 3 7 7 7 7 7 7 7 7 7 7 8 8 8 7 7 7 7 7 7 7 7 7 7 7 7 7 7 7 8 8 7 7 8 8 8 8 7 7 7 7 8 8 7 8 8 7 8 8 3 3 3 3 3 3 3 3
3 3 3 3 3 3 3 3 8 8 8 8 8 8 7 8 8 8 8 8 8 7 8 8 8 8 8 8 8 8 8 8 8 8 8 7 8 8 8 8 8 8 8 8 7 8 8 8 8 8 7 8 8 7 8 8 3 3 3 3 3 3 3 3
3 3 3 3 3 3 3 3 8 8 8 8 8 8 7 8 8 8 8 8 7 8 8 8 8 8 8 8 8 8 8 8 8 8 8 7 8 8 8 8 8 8 8 8 7 8 8 8 8 8 7 8 8 7 8 8 3 3 3 3 3 3 3 3
3 3 3 3 3 3 3 3 8 8 8 8 8 8 7 8 8 7 7 7 7 8 8 7 7 7 7 7 7 7 7 7 7 8 8 7 7 7 7 7 7 7 7 7 7 8 8 8 8 8 8 8 8 8 8 8 3 3 3 3 3 3 3 3
3 3 3 3 3 3 3 3 8 8 8 7 8 8 8 8 8 7 8 8 8 8 8 7 8 8 8 7 8 8 8 8 8 8 8 7 8 8 8 8 8 8 8 8 7 8 8 8 8 8 8 8 8 8 8 8 3 3 3 3 3 3 3 3
3 3 3 3 3 3 3 3 8 8 8 7 8 8 8 8 8 7 8 8 8 8 8 7 8 8 8 7 8 8 8 8 8 8 8 7 8 8 8 8 8 8 8 8 7 7 7 7 7 7 7 7 7 7 8 8 3 3 3 3 3 3 3 3
3 3 3 3 3 3 3 3 8 8 8 7 7 7 7 7 7 7 8 8 8 7 7 7 8 8 8 7 8 8 8 7 7 7 7 7 8 8 8 7 7 7 8 8 8 8 8 8 8 7 8 8 8 8 8 8 3 3 3 3 3 3 3 3
3 3 3 3 3 3 3 3 8 8 8 7 8 8 8 8 8 7 8 8 8 8 8 7 8 8 8 7 8 8 8 8 8 8 8 8 8 8 8 8 8 7 8 8 8 8 8 8 8 7 8 8 8 8 8 8 3 3 3 3 3 3 3 3
3 3 3 3 3 3 3 3 8 8 8 7 8 8 8 8 8 7 8 8 8 8 8 8 8 8 8 7 8 8 8 8 8 8 8 8 8 8 8 8 8 7 8 8 8 8 8 8 8 7 8 8 8 7 7 7 3 3 3 3 3 3 3 3
3 3 3 3 3 3 3 3 8 8 8 8 8 8 8 8 8 7 8 8 8 8 8 8 8 8 8 7 7 7 7 7 7 8 8 7 7 7 7 7 7 7 8 8 8 8 8 8 8 7 8 8 8 8 8 8 3 3 3 3 3 3 3 3
3 3 3 3 3 3 3 3 8 8 8 8 8 8 7 8 8 7 7 7 7 7 8 8 8 8 8 7 8 8 7 8 8 8 8 7 8 8 8 8 8 8 8 8 8 8 8 8 8 7 8 8 8 8 8 8 3 3 3 3 3 3 3 3
3 3 3 3 3 3 3 3 8 8 8 8 8 8 7 8 8 8 8 8 8 7 7 7 7 8 8 7 8 8 7 8 8 8 8 7 8 8 8 8 8 8 8 8 7 7 7 7 7 7 7 7 7 8 8 8 3 3 3 3 3 3 3 3
3 3 3 3 3 3 3 3 8 8 8 8 8 8 7 8 8 8 8 8 8 8 8 8 8 8 8 7 8 8 7 8 8 7 7 7 8 8 7 7 7 7 7 7 7 8 8 8 8 8 8 8 7 8 8 8 3 3 3 3 3 3 3 3
3 3 3 3 3 3 3 3 8 8 7 7 7 7 7 7 7 7 8 8 8 8 8 8 8 8 8 7 8 8 8 8 8 7 8 8 8 8 8 8 8 7 8 8 7 8 8 8 8 8 8 8 7 8 8 8 3 3 3 3 3 3 3 3
3 3 3 3 3 3 3 3 8 8 7 8 8 8 8 8 8 7 7 7 7 7 7 7 7 7 7 7 8 8 8 8 8 7 8 8 8 8 8 8 8 7 8 8 7 8 8 7 7 7 7 7 7 8 8 8 3 3 3 3 3 3 3 3
3 3 3 3 3 3 3 3 8 8 7 8 8 8 8 8 8 8 8 8 8 8 8 8 8 8 8 7 8 8 7 7 7 7 8 8 8 8 8 8 8 7 8 8 7 8 8 7 8 8 8 8 8 8 8 8 3 3 3 3 3 3 3 3
3 3 3 3 3 3 3 3 8 8 8 8 8 8 8 8 8 8 8 8 8 8 8 8 8 8 8 7 8 8 8 8 8 7 8 8 7 7 7 7 7 7 8 8 7 8 8 7 8 8 8 8 8 8 8 8 3 3 3 3 3 3 3 3
3 3 3 3 3 3 3 3 8 8 8 8 8 7 7 7 7 7 7 7 7 7 7 7 8 8 8 7 8 8 8 8 8 7 8 8 8 8 8 8 8 7 8 8 7 8 8 7 8 8 7 7 7 7 7 7 3 3 3 3 3 3 3 3
3 3 3 3 3 3 3 3 8 8 8 8 8 8 8 8 8 8 8 8 8 8 8 8 8 8 8 7 7 7 7 8 8 7 8 8 8 8 8 8 8 7 8 8 7 8 8 7 8 8 7 8 8 8 8 8 3 3 3 3 3 3 3 3
3 3 3 3 3 3 3 3 8 8 8 8 8 8 8 8 8 8 8 8 8 8 8 8 8 8 8 8 8 8 8 8 8 7 8 8 8 8 7 7 7 7 8 8 7 8 8 8 8 8 7 8 8 8 8 8 3 3 3 3 3 3 3 3
3 3 3 3 3 3 3 3 8 8 7 7 7 7 7 7 7 7 8 8 8 8 8 8 8 8 8 8 8 8 8 8 8 7 8 8 8 8 7 8 8 8 8 8 7 8 8 8 8 8 7 8 8 8 8 8 3 3 3 3 3 3 3 3
3 3 3 3 3 3 3 3 8 8 8 8 8 8 7 8 8 7 8 8 8 7 7 7 7 7 7 7 7 7 7 7 7 7 8 8 8 8 7 8 8 8 8 8 8 8 8 8 8 7 7 8 8 7 7 7 3 3 3 3 3 3 3 3
3 3 3 3 3 3 3 3 8 8 8 8 8 8 7 8 8 7 8 8 8 8 8 8 8 8 8 8 7 8 8 8 8 8 8 8 8 8 8 8 8 8 8 8 8 8 8 8 8 7 8 8 8 7 8 8 3 3 3 3 3 3 3 3
3 3 3 3 3 3 3 3 7 7 7 7 8 8 7 8 8 7 8 8 8 8 8 8 8 8 8 8 7 8 8 8 8 8 8 8 8 8 8 8 8 8 8 8 8 8 8 7 7 7 8 8 8 7 8 8 3 3 3 3 3 3 3 3
3 3 3 3 3 3 3 3 8 8 8 7 8 8 7 8 8 7 7 7 7 7 7 7 7 8 8 8 7 8 8 8 8 8 8 8 7 7 7 7 7 7 8 8 8 8 8 7 8 8 8 8 8 7 8 8 3 3 3 3 3 3 3 3
3 3 3 3 3 3 3 3 8 8 8 7 8 8 7 8 8 7 8 8 8 8 8 8 8 8 8 8 7 8 8 8 8 8 8 8 7 8 8 8 8 8 8 8 8 8 8 7 8 8 8 8 8 7 8 8 3 3 3 3 3 3 3 3
3 3 3 3 3 3 3 3 8 8 8 7 8 8 7 8 8 7 8 8 8 8 8 8 8 8 8 8 7 8 8 8 8 8 8 8 7 8 8 8 8 8 8 8 8 8 8 7 8 8 7 7 7 7 8 8 3 3 3 3 3 3 3 3
3 3 3 3 3 3 3 3 8 8 8 7 8 8 7 8 8 7 7 7 7 8 8 8 8 8 8 8 7 8 8 8 8 8 8 8 7 8 8 8 8 8 8 7 7 7 7 7 8 8 7 8 8 8 8 8 3 3 3 3 3 3 3 3
3 3 3 3 3 3 3 3 8 8 8 7 8 8 7 8 8 7 8 8 8 8 8 8 8 8 8 8 7 8 8 8 8 8 8 8 7 8 8 7 8 8 8 8 8 8 8 8 8 8 7 8 8 8 8 8 3 3 3 3 3 3 3 3
3 3 3 3 3 3 3 3 8 8 8 7 8 8 7 8 8 7 8 8 8 8 8 8 8 7 8 8 7 8 8 8 8 8 8 8 7 8 8 7 8 8 8 8 8 8 8 8 8 8 7 7 7 8 8 8 3 3 3 3 3 3 3 3
3 3 3 3 3 3 3 3 8 8 8 7 8 8 7 8 8 7 7 7 7 8 8 8 8 7 8 8 7 7 7 7 7 7 7 7 7 8 8 7 8 8 8 7 7 7 7 7 8 8 8 8 8 8 8 8 3 3 3 3 3 3 3 3
3 3 3 3 3 3 3 3 8 8 8 8 8 8 8 8 8 7 8 8 8 8 8 8 8 7 8 8 8 8 8 8 8 8 8 8 8 8 8 7 8 8 8 8 8 8 8 7 8 8 8 8 8 8 8 8 3 3 3 3 3 3 3 3
3 3 3 3 3 3 3 3 8 8 8 8 8 8 8 8 8 7 8 8 8 8 8 8 8 7 8 8 8 8 8 8 8 8 8 8 8 8 8 7 8 8 8 8 8 8 8 7 8 8 8 8 8 8 8 8 3 3 3 3 3 3 3 3
3 3 3 3 3 3 3 3 3 3 3 3 3 3 3 3 3 3 3 3 3 3 3 3 3 3 3 3 3 3 3 3 3 3 3 3 3 3 3 3 3 3 3 3 3 3 3 3 3 3 3 3 3 3 3 3 3 3 3 3 3 3 3 3
3 3 3 3 3 3 3 3 3 3 3 3 3 3 3 3 3 3 3 3 3 3 3 3 3 3 3 3 3 3 3 3 3 3 3 3 3 3 3 3 3 3 3 3 3 3 3 3 3 3 3 3 3 3 3 3 3 3 3 3 3 3 3 3
3 3 3 3 3 3 3 3 3 3 3 3 3 3 3 3 3 3 3 3 3 3 3 3 3 3 3 3 3 3 3 3 3 3 3 3 3 3 3 3 3 3 3 3 3 3 3 3 3 3 3 3 3 3 3 3 3 3 3 3 3 3 3 3
3 3 3 3 3 3 3 3 3 3 3 3 3 3 3 3 3 3 3 3 3 3 3 3 3 3 3 3 3 3 3 3 3 3 3 3 3 3 3 3 3 3 3 3 3 3 3 3 3 3 3 3 3 3 3 3 3 3 3 3 3 3 3 3
3 3 3 3 3 3 3 3 3 3 3 3 3 3 3 3 3 3 3 3 3 3 3 3 3 3 3 3 3 3 3 3 3 3 3 3 3 3 3 3 3 3 3 3 3 3 3 3 3 3 3 3 3 3 3 3 3 3 3 3 3 3 3 3

